name Guarded by Exits
win 1
#########################
############G############
############E############
############E############
#.......................#
#.......................#
#.......................#
#.......................#
#.......................#
#.......................#
#.......................#
#.......................#
#.......................#
#.......................#
#########################