name Corners
win 6
##############################
#G............##............G#
#.##..........##..........##.#
#.#G..........##..........G#.#
#............................#
#............................#
#............................#
####..........EE..........####
#............................#
#............................#
#............................#
#.#G..........##..........G#.#
#.##..........##..........##.#
#G............##............G#
##############################
